.,.,.,L,.,.,.,.,.,.
.,E,.,.,.,L,.,E,.,.
.,.,.,E,.,.,.,.,.,E
.,.,.,.,E,.,.,.,.,L
X,.,.,.,.,.,E,.,L,L
